11 5
r r b b g g l l o o g
p p u u r r y y r r g
b b g g l l o o p p g
u u r r y y r r b b g
g g l l o o p p u u g